Hemaang Kotta: Happy bday ra! :)
Sanketh Vedula: Happy Birthday ra Praneeth :D
Parvathy Kke: Happy Birthday :)
Deval Shah: Happy birthday !! :)
Sai Eswar Epuri: Happy Birthday :)
Praneeth AG: Happy unte.. Comment vachesthada?
Praneeth AG: Happy birthday cheppanu ga neeku!
Suraj Naidu: Happie b'day ra Surya......
Praneeth AG: Reyyyyy. Happy birthday. Thank you aina type chesthunnava.. Leka code raasesaava. ğŸ˜†ğŸ˜†
Ranjith Raj Vasam: Happy Birthday Surya Teja Cheedella ! :)
Venkat Sai Anurag: HAPPY B'DAY TO U...:)
Gavaskar Gavas: many many happy returns of the day surya
Harshit Jain: Happy Birthday! :D
Neel Shah: happy birthday !
Sashank Karanam: Happy b'day ra..!! :D
Aamir Jowher: Surya!! happy b'day ra!!!
Nayeemullah Baig: happy b'day :) have a great year ahead =D
Guna Sekhar Dora: happy birthday ra Surya :)
Ayush Singhal: Happy Birthday!!
Dinesh Sannala: happy brthday ra
Abhijeet Mulugu: happy bday !!
Harshini Damarla: happy b'day
Pavan Sai: Many many happy returns of d day
Rajesh Varma: Happy bday raa tech boy!!
Bhargavi Addagulla: happy bday..:)
Anirudh Ravi: Happy Birthday! :D
Rajagopal Reddy: happy birtday
Ashmita Roy: happy birthday :)
Jasraj Padhi: Happy birthday !! :)
Sidharth Sahdev: Happy birthday
Anurag Vaidyanathan: Happy Birthday!!
Harish Macharla: happie b'day :D
Chinmaya Patnayak: Wishing you a very very happy birthday. :)
Ã Ã„m RÃ¯ÃŸhÃ­: happie B'day
Rajesh Chagantipati: HAPPY B'DAY RAA :D :D :)
Girish Kurapati: Happy Bday ra
Manoj Kumar: Happy birthday!!
Raahul Saxena: Happy bday broğŸ˜Š
Parth Shah: Happy birthday bro
Amrith Narayan: happy birthday
Kiran Kumar Jayavarapu: Many many happy returns of the day ra
Raviteja Yadlapalli: Happy birthday ra Surya...:)
Bhumit Shingala: Happy Birthday!!!
Abhishek Moturi: Happy birthday :)
Sai Tejeswar Reddy: happy birrthday ra.
Vishnu Reddy: Happy birthday!!! :D
Soumya Reddy Telkala: Happy birthday :)
Harsh Reddy Gandavarapu: Happy birthday!
Yogitha Polavarapu: happy birthday :) have fun
Vamshi Bachaneboina: Happy B'Day D****M******* :3
Basit Omran: many more happpiee returns of the day ra........
Kanniganti Abhishek: Happy birthday!
Mohana Sri Krishna Yerasuri: Many many happy returns of the day ..!! :)
Raghav Rv: happy birthday :)
Macha Srisai: Happy Birthday :)
Sree Krishna: Happy Bday!!
Sri Latha Sunkara: happy bday :)
Srilakshmi Mandapaka: mAnY mAnY hApPy ReTuRnS oF dA dAy...!!! :) :D
Amresh Sahoo: Happy B'day :)
Meghanadh Vejendla: Happy birthday ra Einstein..:)
Vipanchi Reddy Katthula: happy birthday ra :) :D
Sasank Sunkara: Happy birthday  :)
Karthik Polavarapu: happy birthday ra :)
Sai Ramesh Kativarapu: many many more happy returns of the day surya have a wounderful year a head
Srikar Tirunagari: Happy Birthday!
Jaswanth Prathuru: Happiee bday ra
Snigdha Rudraraju: Happy Birthday :)
Usha Kiran: Many more happy retruns of the day surya
Rijul Nayani: happy bday
Sukanya Gorrepati: Happy Birthday........ Have fun :)
Sasi Kanth: Happy Birthday....
Aakash Sadhu: Many many happy returns of the day
Anvesh Reddy Japa: Happy b'day ra !!!!
Mahitha Gandavarapu: Happy bday suryaaa
Chandra Sekhar Kamineni: Happy   birthday ra :)
Chandrahas Tirumalasetty: Happy birthday ra ..
Saisushanth Durvasula: happy birthday ğŸ˜ƒ
Saranya Tammana: Hapieee bdaay ! HF ! :)
Harshit Chand: Happy birthday ra!!!
Venkat Ganugapati: Happy Birthday ra! :D
Meghana Boggarapu: Happy birthday!!!!!!!
Sai Reddy Kallam: Happy birthday Surya Surya bhai
Jemin Kalakoti: Happy birthday ra...!
Naman Bafna: Happy bthday... :)
Bharath Jonnalagadda: Hpy b'day ra.!
Anshik Bansal: Happ b'day bro..jam hard
Lakshmi Reddy Polam: Happy bday :)
Andey Harsha: rei happy bday ra
Harsh Garg: Happy bday :)
Naresh Kikkisetti: happy birthday
Suyash Yeotikar: Many happy returns of the day!!..:)
Mohan Gandhi Alapati: happy birthday!!
Sairam Ravuri: Happy birthday
Mounika Yallamandhala: Happy bday.....
Pardhu Parvataneni: Happiee bday
Sailesh Reddy: happy bday!!
Dinesh Radhakrishnan: Happy birthday :) Have a great yeah ahead!
Srimanth Chowdary: many many happy returns of the day raa... :-)
Sai Palisetti: many many happy returns of the day ra
Teja Reddy: Happy B'Day bro :)
Abhishek Reddy: Happy birthday ra... :)
Bharath Damarla: happie bdy ra....hf
Seetharam Devarasetty: hapiee bday ....
Mokshitha Koneru: Happy birthday..... :)
Chandu Sai Hemanth: Many many happy returns of the day !!!!!!
Kaushik Madakasira: many more happy returns of the day..all the best for your future
Kola Satish: Many more happy returns of the day.
Shreshth Hari: Happy Birthday :)
Mithilesh Mundhada: Happy birthday :)
Tirthankar Saha: Happy Birthday!!
Venkatesh Javvaji: Happy Birthday..!!
Siddhartha Nagalla: Happy Birthday! :)
Chaitanaya Krishna: happy birthday!!!
Chaitanya J Rk: happy b'day mama
Madhu Perumalla: Happy ğŸ˜Š birthday ğŸ‚ to u suryağŸŒŸğŸˆ
Pradeep Kaviti: Many More Happy Returns Of The Day Surya
Sai Sachin: happy b'day ra! :D
Satish Kumar Korada: Happy birthday ra oorudu, sooridu ;-) :-P
Pradyumna Kodali: Happy Birthday!
Saaket Sharma: happy birthday! have a great year ahead! :)
Saaket Sharma: happy birthday! have a great year ahead! :)
Chandu Reddy: Happy Bday :)
Kalyan Pingali: happy birthday
Nihal Rao Cheeti: Happy Birthday! :D
Bhanu Teja Reddy: happy b'day ra........... :) :) :)
Pulkit Singh Tak: happy b'day :)
Shaik Khaleel: happy birthday
